id:1
00 00 00 00 00 00 00 51 12 12 12 12 51 50 50 50 50 50 50 50 50
00 00 00 00 00 00 00 51 12 12 12 12 51 50 50 50 50 50 50 50 50
50 50 50 50 50 50 50 51 12 12 12 12 51 50 50 50 50 50 50 50 50
50 50 50 50 50 50 50 50 50 12 12 50 50 50 50 50 50 50 50 50 50
50 50 50 50 50 50 50 50 50 12 12 50 50 50 50 50 50 50 50 50 50
50 50 50 50 50 50 50 50 50 12 12 50 50 50 50 50 50 50 50 50 50
50 50 50 50 50 50 50 50 50 12 12 50 50 50 50 50 50 50 50 50 50
50 50 50 50 50 50 50 51 12 12 12 12 51 50 50 50 50 50 50 50 50
50 50 50 50 50 50 50 51 12 12 12 12 51 50 50 50 50 50 50 50 50
30 30 30 30 30 30 30 51 12 12 12 12 51 30 30 30 30 30 30 30 30
00 00 00 00 00 00 00 00 00 00 00 00 00 00 00 00 00 00 00 00 00