id:2
56 56 56 56 56 56 56 56 56 56 56 56 56 56 56 56 56 56 56 56 56
56 33 33 33 33 33 33 33 33 33 33 33 33 33 33 33 33 33 33 33 56
56 33 33 33 33 33 33 33 33 33 33 33 33 33 33 33 33 33 33 33 56
33 33 33 33 33 33 33 33 76 76 76 76 76 33 33 33 33 33 33 33 33
33 33 33 33 33 33 33 33 76 76 56 76 76 33 33 33 33 33 33 33 74
76 76 76 76 76 76 76 76 76 56 56 56 76 76 76 76 76 76 76 76 75
33 33 33 33 33 33 33 33 76 76 56 76 76 33 33 33 33 33 33 33 74
33 33 33 33 33 33 33 33 76 76 76 76 76 33 33 33 33 33 33 33 33
56 33 33 33 33 33 33 33 33 33 33 33 33 33 33 33 33 33 33 33 56
56 33 33 33 33 33 33 33 33 33 33 33 33 33 33 33 33 33 33 33 56
56 56 56 56 56 56 56 56 56 56 56 56 56 56 56 56 56 56 56 56 56