id:3
35 35 35 35 35 35 35 35 35 35 35 35 35 35 35 35 35 35 35 35 35
35 35 35 35 35 35 35 35 35 35 35 35 35 35 35 53 53 53 53 53 73
35 35 35 35 35 53 53 53 53 35 35 35 35 35 53 53 35 53 53 53 53
35 35 35 35 73 53 35 35 53 73 35 35 35 35 53 35 35 53 74 53 53
75 75 35 35 53 35 35 35 35 53 35 53 53 73 53 35 35 73 53 53 53
75 75 75 53 53 35 35 35 35 53 53 53 35 35 35 35 35 53 53 53 53
75 75 35 35 35 35 35 35 35 35 35 35 35 35 35 35 35 53 53 73 53
35 35 35 35 35 35 35 35 35 35 35 35 35 35 35 35 35 53 53 53 53
35 35 35 35 35 35 35 35 35 35 35 35 35 35 35 35 35 53 53 74 53
35 35 35 35 35 35 35 35 35 35 35 35 35 35 35 35 35 53 73 53 53
35 35 35 35 35 35 35 35 35 35 35 35 35 35 35 35 35 35 35 35 35
